11,11
WWWWWWWWWWW
W         W
W    D    W
W    C    W
W         W
W DC P CD W
W         W
W    C    W
W    D    W
W         W
WWWWWWWWWWW