5,5,10,9
WWWWWWWWWW
W        W
W PDCC CDW
W   D  CDW
WWWWWW   W
     WD  W
     W CCW
     WD  W
     WWWWW