3,3,7,8
 WWWWW 
WWDCDWW
WD    W
WWC CDW
WDCC WW
WWDCCW 
 WWPDW 
  WWWW 