12,11
WWWWWWWWWWWW
W   CD  D  W
W  CD  C C W
WWWWWCCW   W
    WD WCC W
    WC WPC W
    WD DWW W
    WD D   W
    WD     W
    WD   CDW
    WWWWWWWW