9,15
WWWWWWWWW
WDC W  DW
W C W C W
W C W C W
WDC W C W
W   W   W
WW WWW WW
WD  WDC W
WD  W C W
WCCCWDCDW
WD  C   W
WD  C DDW
WWW C WWW
WWD P DWW
WWD   DWW